%%%%%%%%%%%%%%%%%%%%%%%%%%%%%%%%%%%%%%%%%%%%%%%%%
% .  %.        %     .       %  .%     % %   %  %
%    %%%% %%%%%% %  % % %%         %%%%  %. %%% %
%    %.%    % .% %  % %  %   %   %          %   %
%   .            %.     %%%% %   %% .%%% %      %
% %%%%% %%%%%%  %%%% %           .%    %. %%%%%%%
%.      %   .%       .% %%%  %%%%%%  % %  %   % %
%%% %%  % %%%%%%% %%%%% %    %  . %% % %    %.% %
%    %  %      %  %     %P% %%       %   %%%% % %
%.      %   %  %  %     %          %.      .%   %
% % %%%   .% %    %% %% %%% %% %  %.%%%%%%%%%%% %
%   %   .%    %       %      %    %             %
%%%%%%%%%%%%%%%%%%%%%%%%%%%%%%%%%%%%%%%%%%%%%%%%%
