%%%%%%%%%%%%%%%%%%%%%%%%%%%%%%
%.%     % % %              %.%
% %     % % %%%%%% %%%%%%% % %
%       %        %     % %   %
%%%%% %%%%% %%% %% %%%%% % %%%
%   % % % %   %    %     %   %
% %%% % % % %%%%%%%% %%% %%% %
%       %    P%%     % % %   %
%%% % %%%%%%% %%%% %%% % % % %
% %           %%     %     % %
% % %%%%%%% %%%% % %%% %%% % %
%   %            % %   % %%% %
%.  % %%%%%      % %%% %    .%
%%%%%%%%%%%%%%%%%%%%%%%%%%%%%%