%%%%%%%%%%%%%%%%%%%%%%%%%%%%%%%%%%%%%
%                                   %
%            %                      %
%            %                      %
%            %                      %
%            %                      %
%            %                      %
%            %      %               %
%            %      %               %
%            % p    %               %
%            %      %               %
%            %      %               %
%            %      %               %
%            %      %               %
%%%%%%%%%%%%%%      %%%%%%%%%%%%%%%%%
%            %                      %
%            %                      %
%            %        .             %
%                                   %
%                                   %
%                                   %
%                                   %
%%%%%%%%%%%%%%%%%%%%%%%%%%%%%%%%%%%%%